2111111111111111111112
1000000000000000000001
1000000000000000000001
1000000000011111110001
1000000000010000000001
1000000000010000000001
1011111000010000000001
1000000000010000000001
1000000000010000000001
1000000000010000000001
1000000000011111110001
1000000000000000010001
1000000000000000010001
1000000000000000010001
1001111111100000010001
1001000000000000010001
1001000000000000010001
1001111111100000010001
1000000000000000010001
1000000000000000000001
1000000000000000000001
2111111111111111111112