2111111111111111111112
1000000000000000000001
1000000000000000000001
1000010000000000000001
1000010000000000000001
1000010000000000000001
1000010000000000000001
1000010000000000000001
1000010000000000000001
1000010000000000000001
1000010000000000000001
1000010000000000000001
1000011111100000000001
1000000000000000000001
1000000000000000000001
1000000000000000000001
1000000000000000000001
1000000000000000000001
1000000000000000000001
1000000000000000000001
1000000000000000000001
2111111111111111111112