2111111111111111111112
1000000000000000000001
1111100001111111000001
1000000001000001000001
1000000000000001000001
1000000000000001000001
1000000001111111000001
1000000001000000000001
1000000001111111000001
1000000000000000000001
1000000000000000000001
1000100000000000000001
1000111111111111110001
1000100000000000000001
1000100000000000000001
1000111111110000000001
1000100000000000000001
1000000000000000011111
1000000000000000000001
2111111111111111111112