2111111111111111111112
1000000000000000000001
1000000111111100000001
1000001000000000000001
1000010000000000000001
1000001000000000000001
1000000111111100000001
1000000000000000000001
1000000000100000000001
1000000000100000000001
1000001111211100000001
1000000000100000000001
1000000000100000000001
1000000000000000000001
1000000000100000000001
1000000000100000000001
1000000111211110000001
1000000000100000000001
1000000000100000000001
1000000000000000000001
1000000000000000000001
2111111111111111111112